###################################################
#A    #       #           #           #           #
# ### # ##### # ####### ### ##### ### # ##### ### #
#     # #     # #     #   # #   # #   # #     #   #
# # ### ##### # # ### ### # # # # ### # ##### ### #
# #   #     # #   #     # #   # #   # #       #   #
### ### ### # ##### ##### ####### ### ######### ###
#     # #   #     # #     #       #   #       #   #
##### # # ####### # # ##### ##### ### # ##### # ###
#     # #       # #   #   # #   #   # #   #   #   #
# ##### ####### # ##### # # # # ### # ### # #######
#               #   #   # #   # #   #   # #     # #
# # ##### ##### ### # ### ##### # ##### # ##### # #
# #   #   #   #   # #   #     # #   #   #     #   #
### ### # # # ##### ##### ##### ### # ######### ###
#   #   #   # #     #   #     #   # #       #   # #
# ### ##### # # ##### # ##### ### # ####### # ### #
#   #     # #   #   # #   #   #   #     #   #   # #
##### ### # ##### # # ### # ######### # ##### ### #
#     #   #       # #   # #       #   # #     #   #
# ##### ##### # ### ### # ####### # ### # ##### ###
#       #     #   #   # #     #   #   # #   #     #
####### # # # ### ### # ##### # ### # # # # ### # #
#       # # #   #   # #   #   #     # # # #   # # #
# ######### ##### ### # # # ##### # # # # ### # # #
# #     #   #   #   #   # #       # #     #     # #
# # ###   ### ### ### # # ####### # # ##### ### # #
#   #   #   #   #   #   #       # #       #     #B#
###################################################