######
#   A#
# ####
# #  #
#   ##
### B#