##########
#A   #   #
# ## # # #
# #### #B#
#      # #
# #####  #
#       ##